10 20
####################
#..................#
#..................#
#...!..............#
#..................#
#.......###........#
#..................#
#...!...#......!...#
#.......#..........#
####################